M,M,M,M,M,M,M,M,M,M,
M,0,0,0,0,0,0,0,0,M,
M,0,0,0,0,0,0,0,0,M,
M,0,0,0,F,0,0,0,0,S,
M,0,0,0,0,0,0,0,0,M,
M,0,0,0,M,0,0,0,0,M,
M,0,P,0,M,0,0,0,M,M,
M,0,0,0,M,0,0,0,0,M,
M,0,0,0,M,0,0,0,0,M,
M,M,M,M,M,M,M,M,M,M,
