M,M,M,M,M,M,M,M,M,M,
M,F,0,0,0,0,0,0,0,M,
S,0,0,0,M,0,0,0,0,M,
M,0,0,0,M,0,0,0,0,M,
M,M,M,M,M,0,0,0,0,M,
M,0,0,0,M,0,M,M,M,M,
M,0,M,0,M,0,0,0,0,M,
M,0,M,0,M,M,M,M,0,M,
M,P,M,0,0,0,0,0,0,M,
M,M,M,M,M,M,M,M,M,M,
