M,M,M,M,M,M,M,M,M,M,
M,0,0,0,0,0,0,0,0,M,
M,0,M,0,0,0,0,0,0,M,
S,0,M,0,0,0,0,0,0,M,
M,0,M,P,0,0,0,0,0,M,
M,0,0,0,0,0,0,0,0,M,
M,0,0,0,0,0,0,0,0,M,
M,0,0,0,0,0,0,0,0,M,
M,0,F,M,0,0,0,0,0,M,
M,M,M,M,M,M,M,M,M,M,
