M,M,M,M,M,M,M,M,M,M,
M,F,0,0,0,0,0,0,0,M,
M,P,0,0,0,0,0,0,0,M,
M,0,0,0,0,0,0,0,0,M,
M,M,M,M,M,M,M,M,M,M,
M,0,0,0,M,0,M,M,M,M,
M,0,M,0,M,0,0,0,0,M,
M,0,M,0,M,M,M,M,0,M,
M,0,M,0,0,0,0,0,0,M,
M,S,M,M,M,M,M,M,M,M,
